TCCATTCTCGCTGAGGGGTGGG	XIV
TCCATTCTCGCCGAGGGGTAAC	VIII
TCCATTCTCGCCGAGGGGTGGG	III
TCTATTCTCGCCGAGGTGTGGG	II
TCCATTCTCGCCGTGGGGTAAC	XV
TCCATTCTCGCCGAGGTGTGGG	IX
TTCATTCTCGCCGAGGGGTAAC	V
TCCTTCCTCTTCAAAGGGTAAC	XI
TCCATTCTCGCCAAGGTGTGGG	VI
CCCACTCCCGCCGAGAGGTGGG	I
CCCACTTCCGCCGAGAGGCGGG	VII
CCCACTCCTGCCGAGAGTTGGG	IV
TCCTTTCTCGCCGAGGGGTAAC	X
TCTATTCTTGCCGAGGTGTGGG	XIII
CCCACTTCTGCCGAGAGGCGGG	XII
TCCATTCTCGCCAAGGGGTGGG	XVI
TCTATTCTCGCCGTGGTGTGGG	XVII
TCCATTCTCGCCAAGGGGTAAC	XVIII
TCCATTCTCGCTGAGGGGTAAC	XIX
TCTATTCTCGTCGAGGTGTGGG	XX
TTCATTCTTGCCGAGGGGTAAC	XXI
CCCACTCCCGCCGAGAGTTGGG	XXII
TCCATTCTCGCTGATGGGTGGG	XXIII
TCCATTCTTGCCGAGGGGTAAC	XXIV
TCCATTCTTGCTGAGGGGTGGG	XXV
TCCATTCTCGCCGAGGGGTAGG	XXVI
TCCATTCTCGTTGAGGGGTGGG	XXVII
TCTATTCTCGCCGAGGGGTGGG	XXVIII
TCCATTCTCGCCGAGGTGTAAC	XXIX
TCCATTCTCGCCTAGGGGTAAC	XXX
TCCATTCTCGCTGAGGTGTGGG	XXXI
TTCATTCTCGCCGAGGGGTGGG	XXXII
TCCATTCTCTCCGAGGGGTAAC	XXXIII
TCCATTCTCGTCGAGGGGTAAC	XXXIV
TCCATTCTCGTCGAGGTGTGGG	XXXV
CCCACTTCCGCCGAGGGGCGGG	XXXVI
TCCATTCTCGCCGAGATGTGGG	XXXVII
TCCATTCTCGCCGAGGGGTTGG	XXXVIII
TCCATTCCCGCCGAGGGGTGGG	XXXIX
TCCACTCTCGCCGAGGGGTAAC	XL
CCCATTCTCGCCGAGGTGTGGG	XLI
CCCACTCCCGCCGAGAGGCGGG	XLII
TCTACTCTCGCCGAGGTGTGGG	XLIII
TCCATTCCCGCCGAGGTGTGGG	XLIV
TCTATTCTCGCCGAGGGGTAAC	XLV
TCTATTCTCGCTGAGGTGTGGG	XLVI
TCCACTCTCGCCGAGGGGTGGG	XLVII
TCCATTCTCGCCGAGGTATGGG	XLVIII
TCCATTCTCGTCGAGGGGTGGG	XLIX
TTCATTCTCGCCGAGGCGTAAC	L
CCCACTTCCGCCGATAGGCGGG	LI
CCCACTCCCGCCGAGGGGTGGG	LII
TCCATTCTCGCCGAGGTGTAGG	LIII
TCCATTCCCGCCGAGGGGTAAC	LIV
TCCATTCTCGCCGAGGGGTGGA	LV
TCCACTCTCGCCGAGGTGTGGG	LVI
TCCATTCTCGCCGAGAGGTAAC	LVII
CCCATTCTCGCCGAGGGGTGGG	LVIII
TCTATTCTCGCCGAGGTTTGGG	LIX
TCCATTCTCTCCGAGGTGTGGG	LX
TCCATTCTCGCCGATGGGTAAC	LXI
TCCATTCTCTCCGAGGGGTGGG	LXII
TCCATTCTCGCCGAGGTGTTGG	LXIII
TCTATTCTCACCGAGGTGTGGG	LXIV
TTCATTCTCGCTGAGGGGTGGG	LXV
TCTATTCTCGCCGATGTGTGGG	LXVI
TCTATTCTCGCTGAGGGGTGGG	LXVII
TCCACTCCCGCCGAGAGGTGGG	LXVIII
TTCATTCTCGCCGTGGGGTAAC	LXIX
CCTATTCTCGCCGAGGTGTGGG	LXX
TCTATTCTCGCCGAGGTGTAAC	LXXI
TCCATTTTCGCCGAGGGGTAAC	LXXII
TCCATTCTTGCCGTGGGGTAAC	LXXIII
TCTATTCTCGCCGAGGTGTAGG	LXXIV
TCCATTTTCGCCGAGGTGTGGG	LXXV
TCTATTTTTGCCGAGGTGTGGG	LXXVI
TCTATTCTCTCCGAGGTGTGGG	LXXVII
TCCATTCTCGTCAAGGTGTGGG	LXXVIII
TCCATTCTCGCCGAGGGGTGTG	LXXIX
TCCACTCCCGCCGAGGGGTAAC	LXXX
CCCATTCTCGCCGAGGGGTAAC	LXXXI
TCCATTCTCGCCGATGGGTGGG	LXXXII
TCTATTCTCGCCGAGGTGTGTG	LXXXIII
TCCTTCCTCTTTAAAGGGTAAC	LXXXIV
CCCACTTCCGCCGAGAGGTGGG	LXXXV
TCCATTCTCCCCGAGGGGTGGG	LXXXVI
TTCATTCTCGCCAAGGTGTGGG	LXXXVII
TCTATTCTTGTCGAGGTGTGGG	LXXXVIII
TCTATTCTCGCCGTGGGGTAAC	LXXXIX
TCCATTCTCGCTGAGGCGTGGG	XC
TCCACTCTCGCCAAGGTGTGGG	XCI
CCCATTCTCGCTGAGGGGTGGG	XCII
CCCATTCCCGCCGAGAGGTGGG	XCIII
TTCATTCTCGCCGAGGTGTGGG	XCIV
TCTATTCTCGCCAAGGTGTGGG	XCV
TCCATTCTTGCCGAGGGGTGGG	XCVI
TCCATTCTCGCCGAGGGATGGG	XCVII
TCTATTCTCGCCGAGATGTGGG	XCVIII
TCCATTCTCGTCGTGGGGTAAC	XCIX
TCCATTCTCGCTAAGGTGTGGG	C
TCCATTCTCGCCGAGAGGTGGG	CI
TCCACTCCTGCCGAGAGTTGGG	CII
TTCATTCTCGCTGAGGGGTAAC	CIII
TCCATTCTTGCCGAGGTGTGGG	CIV
TCCATTCTCGCCGATGTGTGGG	CV
CCCACTCTCGCCGAGGGGTGGG	CVI
TTCATTCTCGCCGATGGGTAAC	CVII
TCTATTCTCGCCTAGGTGTGGG	CVIII
TCTATTCTCGCCGAGGTGTTGG	CIX
TCCACTCCCGCCGAGGGGTGGG	CX
TCCATTCTCGCTGAGGGGCGGG	CXI
TTTATTCTCGCCGAGGTGTGGG	CXII
TCCATTCTCGCCGAGGAGTAAC	CXIII
TCCATTCTCGCCGAGGCGTAAC	CXIV
CCCATTCTCGCCGAGAGGTGGG	CXV
TCTATTTTCGCCGAGGTGTGGG	CXVI
TCCATTCTCGCTTAGGGGTGGG	CXVII
TCCATTCTCGCTGTGGGGTAAC	CXVIII
TCCATTCTCGCTAAGGGGTGGG	CXIX
TCCACTCTCGCCGAGATGTGGG	CXX
CCCACTCTCGCCGAGAGGTGGG	CXXI
CCCACTCCTGCCGAGAGTTAGG	CXXII
